CapturingDungeon	Capturing Dungeon!
CapturingGarden	Capturing Garden!
CapturingGreatHall	Capturing Great Hall!
CapturingThrone	Capturing Throne!
CapturingVillage	Capturing Village!
CapturingWalls	Capturing Walls!
CapturedDungeon	Dungeon Captured	
CapturedGarden	Garden Captured	
CapturedGreatHall	Great Hall Captured	
CapturedLowerKeepAttackers	Lower keep captured	Take the throne!
CapturedLowerKeepDefenders	Lower keep captured	Protect the throne!
CapturedThrone	Throne Captured
CapturedVillageAttackers	Village Captured	Storm the walls!
CapturedVillageDefenders	Village Captured	Defend the walls!
CapturedWallsAttackers	Walls Captured	Capture the lower keep!
CapturedWallsDefenders	Walls Captured	Retreat to the keep!
GameStartedAttackers	Siege the castle	Raze the village!
GameStartedDefenders	Guard the castle	Save the village!
GameWon	Game over	Victory!
GameLost	Game over	Defeat!